You got separated from your friends and older brother in a Haunted House Ride at the Local Theme Park. Unfortunately, the staff thought that the last of the guests had left, and all of the doors have been locked. Yet, all of the machines in the house are still strangely working. You fainted from fear at the last ghostly "surprise," and you wake up in an unfamiliar room.

Haunted House of Hallucinations
An Interactive Fiction by Erika Payne Disable take all
Release 1 / Serial number 131011 / Inform 7 build 6G60 (I6/v6.32 lib 6/12N) SD

Black Room
The floor, ceiling, and walls are all black. A booming voice sounds from a speaker coming from the wall saying: "How do you escape a room with NO WINDOWS, and NOOOO DOOORS. HA. HA. HA. HA. HA."

 Trying to calm yourself down, you notice a square section of the wall in front of you is an off black color.

>talk to square
I don't see why you're talking to that.

>push square
A door has opened to the west.
Another door has opened in the north.

>w
Victorian Living Room
Victorian furniture create a gloomy scene in this room, reminding you of a horror movie you watched about a murder in the 1800"s. The fireplace lets off an ominous purple glow (obviously done with purple flashlights and the shifting of the light.) There is a large, comfy couch, a sitting chair, a bookcase, a large painting of a grim old man, and a knight in rusty armor holding an axe.

The Black Room is to the East, and there is a door to the West.

You can see a screwdriver here.

>take screwdriver
[Your score has just gone up by one point.]

>w
Caged Rabid Animal Room
As you open the door letting off a horrifying creak, you see animatronic rats scurrying out of the corner of your eye. This doesn't bother you that much, until you see what is in the room. Large cages with robot animals that have fake foam oozing from their jowls. When you step close to one of the cages, a sensor goes off, and the animals leap against the wall of their cage, growling and chomping at you. It looks like one of the cages is unlocked…

The Living Room is in the East, and the Next Room is in the West.

You can see an Unlocked Cage and a batteries here.

>w
Circus Room
Great. A room devoted to the Circus. You've always hated the Circus, especially clowns. Large robotic clowns loom over you and a demonic low-voiced laughter rings through the room as a waltzing, repetitive circus song plays in the background. There is another podium at the entrance where a worker dressed as a ringmaster is supposed to welcome the guests.

The Cage Room is to the East, and there is a sliding door to the North of the room.

You can see a wrench here.

>take wrench
[Your score has just gone up by one point.]

>n
Graveyard Room
A large, very open room with the ceiling decorated to look like nighttime. The floor is littered with tombstones, but a large tombstone with a skeleton hugging the base of it really sticks out to you. The soundtrack to this room is howling wind and a wolf howling in the background.

The Circus Room is in the South. There is a door to the West that looks like it was decorated to not stand out. A door with a large mirror in the front is to the East. A room with what looks like fog coming out from under the door is to the North.

You can see a wirecutter here.

>w
Staff Break Room
FINALLY. A soundproof room with nothing scary in it. This is obviously a break room for the staff during their downtime. There's a mini fridge, an old TV, an old couch, and a desk.

The entrance to the Graveyard is to the East, and there is a metal door to the North.

>e
Graveyard Room
A large, very open room with the ceiling decorated to look like nighttime. The floor is littered with tombstones, but a large tombstone with a skeleton hugging the base of it really sticks out to you. The soundtrack to this room is howling wind and a wolf howling in the background.

The Circus Room is in the South. There is a door to the West that looks like it was decorated to not stand out. A door with a large mirror in the front is to the East. A room with what looks like fog coming out from under the door is to the North.

You can see a wirecutter here.

>take wirecutter
[Your score has just gone up by one point.]

* * *

>w
Staff Break Room
FINALLY. A soundproof room with nothing scary in it. This is obviously a break room for the staff during their downtime. There's a mini fridge, an old TV, an old couch, and a desk.

The entrance to the Graveyard is to the East, and there is a metal door to the North.

>n
Control Panel Room
An old man is fumbling around with one of the boxes on the wall, cutting wires and reconnecting others. He must be the electrician, maybe he can help you find a way out! This seems to be the Control Panel room that has all the wires and switches causing the electricity to work. Someone must have forgotten to switch off the ride, since lights are flashing next to the switches labeled:

 Lighting
 Fog
 Soundtracks

You should turn off the fog and soundtracks, but leave the lighting on so you can see.

The Staff Break Room is South.

You can see an old electrician here.

>talk to old electrician
"What are you doing here, the ride's closed! ... What? They locked you in while closing down? Sorry to hear that, but I can't help you. I only got the one spare key, and I'm gonna be here for a couple hours. Maybe we can make an exchange though, I seem to be missing some of my tools… Three of them to be exact. I probably dropped them in some of the rooms that came before the graveyard. Try giving a look for them, this old heart of mine couldn't stand going through that Circus Room again."

>give electrician wrench
Thanks kid!

[Your score has just gone up by one point.]

>give electrician the wirecutter
Thanks kid!

[Your score has just gone up by one point.]

* * *

>x player
You can't see any such thing.

>x me
You got locked inside one of the scariest rides in the theme park and got seperated from your older brother and friends. Your feeling pretty freaked out right now.

* * *

>push square
A door has opened to the west.
Another door has opened in the north.

* * *

>w
Victorian Living Room
Victorian furniture create a gloomy scene in this room, reminding you of a horror movie you watched about a murder in the 1800"s. The fireplace lets off an ominous purple glow (obviously done with purple flashlights and the shifting of the light.) There is a large, comfy couch, a sitting chair, a bookcase, a large painting of a grim old man, and a knight in rusty armor holding an axe.

The Black Room is to the East, and there is a door to the West.

You can see a screwdriver here.

>w
Caged Rabid Animal Room
As you open the door letting off a horrifying creak, you see animatronic rats scurrying out of the corner of your eye. This doesn't bother you that much, until you see what is in the room. Large cages with robot animals that have fake foam oozing from their jowls. When you step close to one of the cages, a sensor goes off, and the animals leap against the wall of their cage, growling and chomping at you. It looks like one of the cages is unlocked…

The Living Room is in the East, and the Next Room is in the West.

You can see an Unlocked Cage and a batteries here.

* * *

>w
Circus Room
Great. A room devoted to the Circus. You've always hated the Circus, especially clowns. Large robotic clowns loom over you and a demonic low-voiced laughter rings through the room as a waltzing, repetitive circus song plays in the background. There is another podium at the entrance where a worker dressed as a ringmaster is supposed to welcome the guests.

The Cage Room is to the East, and there is a sliding door to the North of the room.

You can see a wrench here.

>n
Graveyard Room
A large, very open room with the ceiling decorated to look like nighttime. The floor is littered with tombstones, but a large tombstone with a skeleton hugging the base of it really sticks out to you. The soundtrack to this room is howling wind and a wolf howling in the background.

The Circus Room is in the South. There is a door to the West that looks like it was decorated to not stand out. A door with a large mirror in the front is to the East. A room with what looks like fog coming out from under the door is to the North.

You can see a wirecutter here.

* * *

>n
Control Panel Room
An old man is fumbling around with one of the boxes on the wall, cutting wires and reconnecting others. He must be the electrician, maybe he can help you find a way out! This seems to be the Control Panel room that has all the wires and switches causing the electricity to work. Someone must have forgotten to switch off the ride, since lights are flashing next to the switches labeled:

 Lighting
 Fog
 Soundtracks

You should turn off the fog and soundtracks, but leave the lighting on so you can see.

The Staff Break Room is South.

You can see an old electrician here.

>pull lever for fog
It is fixed in place.

* * *

>n
Control Panel Room
An old man is fumbling around with one of the boxes on the wall, cutting wires and reconnecting others. He must be the electrician, maybe he can help you find a way out! This seems to be the Control Panel room that has all the wires and switches causing the electricity to work. Someone must have forgotten to switch off the ride, since lights are flashing next to the switches labeled:

 Lighting
 Fog
 Soundtracks

You should turn off the fog and soundtracks, but leave the lighting on so you can see.

The Staff Break Room is South.

You can see an old electrician here.

>push button for lighting
I don't think that's a good idea.

>push button for fog
You hear a clicking noise. Something must have happened.

>push button for fog
You hear a clicking noise. Something must have happened.

>push button for soundtracks
You hear a clicking noise. It seems quieter outside, something must have happened.

>s
Staff Break Room
FINALLY. A soundproof room with nothing scary in it. This is obviously a break room for the staff during their downtime. There's a mini fridge, an old TV, an old couch, and a desk.

The entrance to the Graveyard is to the East, and there is a metal door to the North.

>w
You can't go that way.

>e
Graveyard Room
A large, very open room with the ceiling decorated to look like nighttime. The floor is littered with tombstones, but a large tombstone with a skeleton hugging the base of it really sticks out to you. The soundtrack to this room is howling wind and a wolf howling in the background.

The Circus Room is in the South. There is a door to the West that looks like it was decorated to not stand out. A door with a large mirror in the front is to the East. A room with what looks like fog coming out from under the door is to the North.

You can see a wirecutter here.

>n
Meat Locker
Large sacks of what looks like cow meat hang from the ceiling on metal hooks. Obviously, their plastic, but it still gives you the creeps being wrapped in the cloudy plastic. Usually, a worker dawning a butcher's outfit chases the visitors around towards the exit, but the fog is so thick, you can't see it.

 The Graveyard is South. There is a large cobwebbed door to the East.

You can see a Cobwebbed door here.

>s
Graveyard Room
A large, very open room with the ceiling decorated to look like nighttime. The floor is littered with tombstones, but a large tombstone with a skeleton hugging the base of it really sticks out to you. The soundtrack to this room is howling wind and a wolf howling in the background.

The Circus Room is in the South. There is a door to the West that looks like it was decorated to not stand out. A door with a large mirror in the front is to the East. A room with what looks like fog coming out from under the door is to the North.

You can see a wirecutter here.

>s
Circus Room
Large, robotic clowns loom over you as you walk by. There is another podium at the entrance where a worker dressed as a ringmaster is supposed to welcome the guests. The Cage Room is to the East, and there is a sliding door to the North of the room.

 The room is now silent.

You can see a wrench here.

* * *

>n
Control Panel Room
An old man is fumbling around with one of the boxes on the wall, cutting wires and reconnecting others. He must be the electrician, maybe he can help you find a way out! This seems to be the Control Panel room that has all the wires and switches causing the electricity to work. Someone must have forgotten to switch off the ride, since lights are flashing next to the switches labeled:

 Lighting
 Fog
 Soundtracks

You should turn off the fog and soundtracks, but leave the lighting on so you can see.

The Staff Break Room is South.

You can see an old electrician here.

>push lighting
I don't think that's a good idea.

It is fixed in place.

>push fog
It is fixed in place.

* * *

>n
Graveyard Room
A large, very open room with the ceiling decorated to look like nighttime. The floor is littered with tombstones, but a large tombstone with a skeleton hugging the base of it really sticks out to you. The soundtrack to this room is howling wind and a wolf howling in the background.

The Circus Room is in the South. There is a door to the West that looks like it was decorated to not stand out. A door with a large mirror in the front is to the East. A room with what looks like fog coming out from under the door is to the North.

You can see a wirecutter here.

>wn
That's not a verb I recognise.

>w
Staff Break Room
FINALLY. A soundproof room with nothing scary in it. This is obviously a break room for the staff during their downtime. There's a mini fridge, an old TV, an old couch, and a desk.

The entrance to the Graveyard is to the East, and there is a metal door to the North.

* * *

>n
Control Panel Room
An old man is fumbling around with one of the boxes on the wall, cutting wires and reconnecting others. He must be the electrician, maybe he can help you find a way out! This seems to be the Control Panel room that has all the wires and switches causing the electricity to work. Someone must have forgotten to switch off the ride, since lights are flashing next to the switches labeled:

 Lighting
 Fog
 Soundtracks

You should turn off the fog and soundtracks, but leave the lighting on so you can see.

The Staff Break Room is South.

You can see an old electrician here.

>push lighting
I don't think that's a good idea.

* * *

>w
Circus Room
Great. A room devoted to the Circus. You've always hated the Circus, especially clowns. Large robotic clowns loom over you and a demonic low-voiced laughter rings through the room as a waltzing, repetitive circus song plays in the background. There is another podium at the entrance where a worker dressed as a ringmaster is supposed to welcome the guests.

The Cage Room is to the East, and there is a sliding door to the North of the room.

You can see a wrench here.

I beg your pardon?

>n
Graveyard Room
A large, very open room with the ceiling decorated to look like nighttime. The floor is littered with tombstones, but a large tombstone with a skeleton hugging the base of it really sticks out to you. The soundtrack to this room is howling wind and a wolf howling in the background.

The Circus Room is in the South. There is a door to the West that looks like it was decorated to not stand out. A door with a large mirror in the front is to the East. A room with what looks like fog coming out from under the door is to the North.

You can see a wirecutter here.

* * *

>e
Graveyard Room
A large, very open room with the ceiling decorated to look like nighttime. The floor is littered with tombstones, but a large tombstone with a skeleton hugging the base of it really sticks out to you. The soundtrack to this room is howling wind and a wolf howling in the background.

The Circus Room is in the South. There is a door to the West that looks like it was decorated to not stand out. A door with a large mirror in the front is to the East. A room with what looks like fog coming out from under the door is to the North.

You can see a wirecutter here.

>w
Staff Break Room
FINALLY. A soundproof room with nothing scary in it. This is obviously a break room for the staff during their downtime. There's a mini fridge, an old TV, an old couch, and a desk.

The entrance to the Graveyard is to the East, and there is a metal door to the North.

* * *

>n
Control Panel Room
An old man is fumbling around with one of the boxes on the wall, cutting wires and reconnecting others. He must be the electrician, maybe he can help you find a way out! This seems to be the Control Panel room that has all the wires and switches causing the electricity to work. Someone must have forgotten to switch off the ride, since lights are flashing next to the switches labeled:

 Lighting
 Fog
 Soundtracks

You should turn off the fog and soundtracks, but leave the lighting on so you can see.

The Staff Break Room is South.

You can see an old electrician here.

>push soundtracks
You hear a clicking noise. It seems quieter outside, something must have happened.

>s
Staff Break Room
FINALLY. A soundproof room with nothing scary in it. This is obviously a break room for the staff during their downtime. There's a mini fridge, an old TV, an old couch, and a desk.

The entrance to the Graveyard is to the East, and there is a metal door to the North.

>e
Graveyard Room
A large, very open room with the ceiling decorated to look like nighttime. The floor is littered with tombstones, but a large tombstone with a skeleton hugging the base of it really sticks out to you. The Circus Room is in the South. There is a door to the West that looks like it was decorated to not stand out. A door with a large mirror in the front is to the East.
 The room is silent.

You can see a wirecutter here.

You see a shadow of a little girl running out of the corner of your eye.

* * *

>w
Caged Rabid Animal Room
As you open the door letting off a horrifying creak, you see animatronic rats scurrying out of the corner of your eye. This doesn't bother you that much, until you see what is in the room. Large cages with robot animals that have fake foam oozing from their jowls. When you step close to one of the cages, a sensor goes off, and the animals leap against the wall of their cage, growling and chomping at you. It looks like one of the cages is unlocked…

The Living Room is in the East, and the Next Room is in the West.

You can see an Unlocked Cage and a batteries here.

>n
You can't go that way.

>w
Circus Room
Great. A room devoted to the Circus. You've always hated the Circus, especially clowns. Large robotic clowns loom over you and a demonic low-voiced laughter rings through the room as a waltzing, repetitive circus song plays in the background. There is another podium at the entrance where a worker dressed as a ringmaster is supposed to welcome the guests.

The Cage Room is to the East, and there is a sliding door to the North of the room.

You can see a wrench here.

* * *

>n
Control Panel Room
An old man is fumbling around with one of the boxes on the wall, cutting wires and reconnecting others. He must be the electrician, maybe he can help you find a way out! This seems to be the Control Panel room that has all the wires and switches causing the electricity to work. Someone must have forgotten to switch off the ride, since lights are flashing next to the switches labeled:

 Lighting
 Fog
 Soundtracks

You should turn off the fog and soundtracks, but leave the lighting on so you can see.

The Staff Break Room is South.

You can see an old electrician here.

>turn off fog
That's already off.

>turn on fog
You switch the Switch for Fog on.

* * *

>n
Graveyard Room
A large, very open room with the ceiling decorated to look like nighttime. The floor is littered with tombstones, but a large tombstone with a skeleton hugging the base of it really sticks out to you. The soundtrack to this room is howling wind and a wolf howling in the background.

The Circus Room is in the South. There is a door to the West that looks like it was decorated to not stand out. A door with a large mirror in the front is to the East. A room with what looks like fog coming out from under the door is to the North.

You can see a wirecutter here.

>take wirecutter
[Your score has just gone up by one point.]

* * *

>n
Control Panel Room
An old man is fumbling around with one of the boxes on the wall, cutting wires and reconnecting others. He must be the electrician, maybe he can help you find a way out! This seems to be the Control Panel room that has all the wires and switches causing the electricity to work. Someone must have forgotten to switch off the ride, since lights are flashing next to the switches labeled:

 Lighting
 Fog
 Soundtracks

You should turn off the fog and soundtracks, but leave the lighting on so you can see.

The Staff Break Room is South.

You can see an old electrician here.

>give old electrician wrench
Thanks kid!

[Your score has just gone up by one point.]

>give screwdriver
(to the old electrician)
Thanks kid!

[Your score has just gone up by one point.]

>give wirecutter
(to the old electrician)
Thanks kid!

[Your score has just gone up by one point.]

* * *

>n
Control Panel Room
An old man is fumbling around with one of the boxes on the wall, cutting wires and reconnecting others. He must be the electrician, maybe he can help you find a way out! This seems to be the Control Panel room that has all the wires and switches causing the electricity to work. Someone must have forgotten to switch off the ride, since lights are flashing next to the switches labeled:

 Lighting
 Fog
 Soundtracks

You should turn off the fog and soundtracks, but leave the lighting on so you can see.

The Staff Break Room is South.

You can see an old electrician here.

>give wirecutter
(to the old electrician)
Thanks kid!

[Your score has just gone up by one point.]

>give wrench
(to the old electrician)
Thanks kid!

[Your score has just gone up by one point.]

>give screwdriver
(to the old electrician)
Thanks kid!

"Thanks a bunch kid! Here's the key that leads out of the Meat Locker. After the Narrow Hallway, you should be home free to the exit! Just leave the key for me though on the ground in the butcher room so I can get out too."

[Your score has just gone up by one point.]

>s
Staff Break Room
FINALLY. A soundproof room with nothing scary in it. This is obviously a break room for the staff during their downtime. There's a mini fridge, an old TV, an old couch, and a desk.

The entrance to the Graveyard is to the East, and there is a metal door to the North.

"Thanks a bunch kid! Here's the key that leads out of the Meat Locker. After the Narrow Hallway, you should be home free to the exit! Just leave the key for me though on the ground in the butcher room so I can get out too."

* * *

>talk to old electrician
"What are you doing here, the ride's closed! ... What? They locked you in while closing down? Sorry to hear that, but I can't help you. I only got the one spare key, and I'm gonna be here for a couple hours. Maybe we can make an exchange though, I seem to be missing some of my tools… Three of them to be exact. I probably dropped them in some of the rooms that came before the graveyard. Try giving a look for them, this old heart of mine couldn't stand going through that Circus Room again."

>give wrench
(to the old electrician)
Thanks kid!

[Your score has just gone up by one point.]

>give wirecutter
(to the old electrician)
Thanks kid!

[Your score has just gone up by one point.]

>give screwdriver
(to the old electrician)
Thanks kid!

You see a shadow of a little girl running out of the corner of your eye.

"Thanks a bunch kid! Here's the key that leads out of the Meat Locker. After the Narrow Hallway, you should be home free to the exit! Just leave the key for me though on the ground in the butcher room so I can get out too."

[Your score has just gone up by one point.]

>i
You are carrying:
  an Exit Key

"Thanks a bunch kid! Here's the key that leads out of the Meat Locker. After the Narrow Hallway, you should be home free to the exit! Just leave the key for me though on the ground in the butcher room so I can get out too."

>s
Staff Break Room
FINALLY. A soundproof room with nothing scary in it. This is obviously a break room for the staff during their downtime. There's a mini fridge, an old TV, an old couch, and a desk.

The entrance to the Graveyard is to the East, and there is a metal door to the North.

You see a shadow of a little girl running out of the corner of your eye.

"Thanks a bunch kid! Here's the key that leads out of the Meat Locker. After the Narrow Hallway, you should be home free to the exit! Just leave the key for me though on the ground in the butcher room so I can get out too."

* * *

>n
Control Panel Room
An old man is fumbling around with one of the boxes on the wall, cutting wires and reconnecting others. He must be the electrician, maybe he can help you find a way out! This seems to be the Control Panel room that has all the wires and switches causing the electricity to work. Someone must have forgotten to switch off the ride, since lights are flashing next to the switches labeled:

 Lighting
 Fog
 Soundtracks

You should turn off the fog and soundtracks, but leave the lighting on so you can see.

The Staff Break Room is South.

You can see an old electrician here.

>give electrician wrench
Thanks kid!

[Your score has just gone up by one point.]

>give electrician screwdriveer
Thanks kid!

[Your score has just gone up by one point.]

* * *

>give electrician wrench
Thanks kid!

[Your score has just gone up by one point.]

>give electrician wirecutter
Thanks kid!

[Your score has just gone up by one point.]

>give electrician screwdriver
Thanks kid!

"Thanks a bunch kid! Here's the key that leads out of the Meat Locker. After the Narrow Hallway, you should be home free to the exit! Just leave the key for me though on the ground in the butcher room so I can get out too."

[Your score has just gone up by one point.]

>s
Staff Break Room
FINALLY. A soundproof room with nothing scary in it. This is obviously a break room for the staff during their downtime. There's a mini fridge, an old TV, an old couch, and a desk.

The entrance to the Graveyard is to the East, and there is a metal door to the North.

>s
You can't go that way.

>e
Graveyard Room
A large, very open room with the ceiling decorated to look like nighttime. The floor is littered with tombstones, but a large tombstone with a skeleton hugging the base of it really sticks out to you. The soundtrack to this room is howling wind and a wolf howling in the background.

The Circus Room is in the South. There is a door to the West that looks like it was decorated to not stand out. A door with a large mirror in the front is to the East. A room with what looks like fog coming out from under the door is to the North.

* * *

>take wirecutter
[Your score has just gone up by one point.]

>n
Meat Locker
It's too foggy to really see anything. There might be a door to the east. You just entered from the graveyard in the south.

You can see a Cobwebbed door here.

* * *

>w
Staff Break Room
FINALLY. A soundproof room with nothing scary in it. This is obviously a break room for the staff during their downtime. There's a mini fridge, an old TV, an old couch, and a desk.

The entrance to the Graveyard is to the East, and there is a metal door to the North.

>n
Control Panel Room
An old man is fumbling around with one of the boxes on the wall, cutting wires and reconnecting others. He must be the electrician, maybe he can help you find a way out! This seems to be the Control Panel room that has all the wires and switches causing the electricity to work. Someone must have forgotten to switch off the ride, since lights are flashing next to the switches labeled:

 Lighting
 Fog
 Soundtracks

You should turn off the fog and soundtracks, but leave the lighting on so you can see.

The Staff Break Room is South.

You can see an old electrician here.

You see a shadow of a little girl running out of the corner of your eye.

>give old electrician wrench
Thanks kid!

[Your score has just gone up by one point.]

>give old electrician screwdriver
Thanks kid!

[Your score has just gone up by one point.]

>give old electrician wirecutter
Thanks kid!

"Thanks a bunch kid! Here's the key that leads out of the Meat Locker. After the Narrow Hallway, you should be home free to the exit! Just leave the key for me though on the ground in the butcher room so I can get out too."

[Your score has just gone up by one point.]

>s
Staff Break Room
FINALLY. A soundproof room with nothing scary in it. This is obviously a break room for the staff during their downtime. There's a mini fridge, an old TV, an old couch, and a desk.

The entrance to the Graveyard is to the East, and there is a metal door to the North.

"Thanks a bunch kid! Here's the key that leads out of the Meat Locker. After the Narrow Hallway, you should be home free to the exit! Just leave the key for me though on the ground in the butcher room so I can get out too."

* * *

>take wrench
[Your score has just gone up by one point.]

>b
That's not a verb I recognise.

>n
Graveyard Room
A large, very open room with the ceiling decorated to look like nighttime. The floor is littered with tombstones, but a large tombstone with a skeleton hugging the base of it really sticks out to you. The soundtrack to this room is howling wind and a wolf howling in the background.

The Circus Room is in the South. There is a door to the West that looks like it was decorated to not stand out. A door with a large mirror in the front is to the East. A room with what looks like fog coming out from under the door is to the North.

You can see a wirecutter here.

* * *

>give electrician wrench
Thanks kid!

[Your score has just gone up by one point.]

>give electrician screwdriver
Thanks kid!

[Your score has just gone up by one point.]

>give electrician wirecutter
Thanks kid!

"Thanks a bunch kid! Here's the key that leads out of the Meat Locker. After the Narrow Hallway, you should be home free to the exit! Just leave the key for me though on the ground in the butcher room so I can get out too."

[Your score has just gone up by one point.]

>i
You are carrying:
  an Exit Key

"Thanks a bunch kid! Here's the key that leads out of the Meat Locker. After the Narrow Hallway, you should be home free to the exit! Just leave the key for me though on the ground in the butcher room so I can get out too."

* * *

>e
You can't go that way.

* * *

>x old electrician
An old man wearing a grey jumpsuit cutting and reconnecting wires. Whatever he's doing looks very confusing.  He is carrying the key to the exit. He looks annoyed.

>talk to old electrician
That's not a verb I recognise.

* * *

>take exit keyu
I only understood you as far as wanting to take the Exit Key.

>take exit key
Taken.

>s
Staff Break Room
FINALLY. A soundproof room with nothing scary in it. This is obviously a break room for the staff during their downtime. There's a mini fridge, an old TV, an old couch, and a desk.

The entrance to the Graveyard is to the East, and there is a metal door to the North.

You can see a Mini Fridge, an Old TV, an Old Couch, and a Desk here.

>e
Graveyard Room
A large, very open room with the ceiling decorated to look like nighttime. The floor is littered with tombstones, but a large tombstone with a skeleton hugging the base of it really sticks out to you. The soundtrack to this room is howling wind and a wolf howling in the background.

The Circus Room is in the South. There is a door to the West that looks like it was decorated to not stand out. A door with a large mirror in the front is to the East. A room with what looks like fog coming out from under the door is to the North.

You can see a Tombstones, a Large Tombstone, and a Skeleton here.

>n
Meat Locker
Large sacks of what looks like cow meat hang from the ceiling on metal hooks. Obviously, their plastic, but it still gives you the creeps being wrapped in the cloudy plastic. Usually, a worker dawning a butcher's outfit chases the visitors around towards the exit, but the fog is so thick, you can't see it.

 The Graveyard is South. There is a large cobwebbed door to the East.

You can see a Cobwebbed door, a Cow Meat, and a Metal Hooks here.

>e
(first opening the Cobwebbed door)
It seems to be locked.

>unlock cobwebbed door
(with the Exit Key)
You unlock the Cobwebbed door.

>e
(first opening the Cobwebbed door)

Narrow Hall of Terror
All you see is darkness. You need something to light the pathway, but you can tell the room is very narrow.

You can see a Cobwebbed door, a Cobwebs, and a Robotic Hands here.