You got separated from your friends and older brother in a Haunted House Ride at the Local Theme Park. Unfortunately, the staff thought that the last of the guests had left, and all of the doors have been locked. Yet, all of the machines in the house are still strangely working. You fainted from fear at the last ghostly "surprise," and you wake up in an unfamiliar room.

Haunted House of Hallucinations
An Interactive Fiction by Erika Payne Disable take all
Release 1 / Serial number 131018 / Inform 7 build 6G60 (I6/v6.32 lib 6/12N) SD

Black Room
The floor, ceiling, and walls are all black. A booming voice sounds from a speaker coming from the wall saying: "How do you escape a room with NO WINDOWS, and NOOOO DOOORS. HA. HA. HA. HA. HA."

 Trying to calm yourself down, you notice a square section of the wall in front of you is an off black color.

>push sqaure
You can't see any such thing.

>push square
A door has opened to the west.
Another door has opened in the north.

>w
Victorian Living Room
Victorian furniture create a gloomy scene in this room, reminding you of a horror movie you watched about a murder in the 1800"s. The fireplace lets off an ominous purple glow (obviously done with purple flashlights and the shifting of the light.)

There is a large, comfy couch, a sitting chair, a bookcase, a large painting of a grim old man, and a knight in rusty armor holding an axe.

The Black Room is to the East, and there is a door to the West.

>w
Caged Rabid Animal Room
As you open the door letting off a horrifying creak, you see animatronic rats scurrying out of the corner of your eye. This doesn't bother you that much, until you see what is in the room. Large cages with robot animals that have fake foam oozing from their jowls. When you step close to one of the cages, a sensor goes off, and the animals leap against the wall of their cage, growling and chomping at you.

It looks like one of the cages is unlocked…愠楮

The Living Room is in the East, and the Next Room is in the West.

You see a shadow of a little girl running out of the corner of your eye.

>w
Circus Room
Great. A room devoted to the Circus. You've always hated the Circus, especially clowns. Large robotic clowns loom over you and a demonic low-voiced laughter rings through the room as a waltzing, repetitive circus song plays in the background. There is another podium at the entrance where a worker dressed as a ringmaster is supposed to welcome the guests.

The Cage Room is to the East.

>n
You can't go that way.

>push button
A door slides open in the North.

>n
You can't go that way.

* * *

>n
(first opening the Second door)
It seems to be locked.

I beg your pardon?

>push square
A door has opened to the west.
Another door has opened in the north.

>n
Entrance to the ride
The front door is barricaded from the outside, so you'll have to find another exit, which should be at the end of the ride. The room is dimly lighted with a podium at the front were a greeter stands to maintain the line.

South is the first room of the ride.

>take flashlight
Taken.

>s
Black Room
The floor, ceiling, and walls are all black. A booming voice sounds from a speaker coming from the wall saying: "How do you escape a room with NO WINDOWS, and NOOOO DOOORS. HA. HA. HA. HA. HA."

 Trying to calm yourself down, you notice a square section of the wall in front of you is an off black color.

>w
Victorian Living Room
Victorian furniture create a gloomy scene in this room, reminding you of a horror movie you watched about a murder in the 1800"s. The fireplace lets off an ominous purple glow (obviously done with purple flashlights and the shifting of the light.) There is a large, comfy couch, a sitting chair, a bookcase, a large painting of a grim old man, and a knight in rusty armor holding an axe.

The Black Room is to the East, and there is a door to the West.

>take wrench
You can't see any such thing.

>take screwdriver
[Your score has just gone up by one point.]

>w
Caged Rabid Animal Room
As you open the door letting off a horrifying creak, you see animatronic rats scurrying out of the corner of your eye. This doesn't bother you that much, until you see what is in the room. Large cages with robot animals that have fake foam oozing from their jowls. When you step close to one of the cages, a sensor goes off, and the animals leap against the wall of their cage, growling and chomping at you.

It looks like one of the cages is unlocked…愠楮

The Living Room is in the East, and the Next Room is in the West.

>take batteries
Taken.

>w
Circus Room
Great. A room devoted to the Circus. You've always hated the Circus, especially clowns. Large robotic clowns loom over you and a demonic low-voiced laughter rings through the room as a waltzing, repetitive circus song plays in the background. There is another podium at the entrance where a worker dressed as a ringmaster is supposed to welcome the guests.

The Cage Room is to the East, and there is a sliding door to the North of the room.

>take wrench
[Your score has just gone up by one point.]

>n
Graveyard Room
A large, very open room with the ceiling decorated to look like nighttime. The floor is littered with tombstones, but a large tombstone with a skeleton hugging the base of it really sticks out to you. The soundtrack to this room is howling wind and a wolf howling in the background.

The Circus Room is in the South. There is a door to the West that looks like it was decorated to not stand out. A door with a large mirror in the front is to the East. A room with what looks like fog coming out from under the door is to the North.

>take wirecutter
[Your score has just gone up by one point.]

>w
Staff Break Room
FINALLY. A soundproof room with nothing scary in it. This is obviously a break room for the staff during their downtime. There's a mini fridge, an old TV, an old couch, and a desk.

The entrance to the Graveyard is to the East, and there is a metal door to the North.

>n
Control Panel Room
An old man is fumbling around with one of the boxes on the wall, cutting wires and reconnecting others. He must be the electrician, maybe he can help you find a way out! Try talking to him!!!

This seems to be the Control Panel room that has all the wires and buttons causing the electricity to work. Someone must have forgotten to switch off the ride, since lights are flashing next to the buttons labeled:

 Lighting
 Fog
 Soundtracks

You should press the fog and soundtracks buttons, but leave the lighting on so you can see.

The Staff Break Room is South.

You can see an old electrician here.

>press fog
You hear a clicking noise. Something must have happened.

>give electrician wrench
Thanks!

[Your score has just gone up by one point.]

>give electrician wirecutter
Thanks!

[Your score has just gone up by one point.]

>give electrician screwdriver
Thanks!

"Thanks a bunch kid! Here's the key that leads out of the Meat Locker. After the Narrow Hallway, you should be home free to the exit! Just leave the key for me though on the ground in the butcher room so I can get out too."

[Your score has just gone up by one point.]

>s
Staff Break Room
FINALLY. A soundproof room with nothing scary in it. This is obviously a break room for the staff during their downtime. There's a mini fridge, an old TV, an old couch, and a desk.

The entrance to the Graveyard is to the East, and there is a metal door to the North.

>e
Graveyard Room
A large, very open room with the ceiling decorated to look like nighttime. The floor is littered with tombstones, but a large tombstone with a skeleton hugging the base of it really sticks out to you. The soundtrack to this room is howling wind and a wolf howling in the background.

The Circus Room is in the South. There is a door to the West that looks like it was decorated to not stand out. A door with a large mirror in the front is to the East. A room with what looks like fog coming out from under the door is to the North.

>n
Meat Locker
Large sacks of what looks like cow meat hang from the ceiling on metal hooks. Obviously, their plastic, but it still gives you the creeps being wrapped in the cloudy plastic. Usually, a worker dawning a butcher's outfit chases the visitors around towards the exit, but the fog is so thick, you can't see it.

 The Graveyard is South. There is a large cobwebbed door to the East.

You can see a Cobwebbed door here.

>unlock cobwebbed door
What do you want to unlock the Cobwebbed door with?

>key
You unlock the Cobwebbed door.

>e
(first opening the Cobwebbed door)

Darkness
It is pitch dark, and you can't see a thing.

>w
Meat Locker
Large sacks of what looks like cow meat hang from the ceiling on metal hooks. Obviously, their plastic, but it still gives you the creeps being wrapped in the cloudy plastic. Usually, a worker dawning a butcher's outfit chases the visitors around towards the exit, but the fog is so thick, you can't see it.

 The Graveyard is South. There is a large cobwebbed door to the East.

You can see a Cobwebbed door here.

>e
Darkness
It is pitch dark, and you can't see a thing.

>e
Exit
FREEEEDOM! You feel the fresh air blowing through your hair, the sunlight against your skin, and the smell of food coming from the vendors parked across the street. Eventually, you meet up with your friends, and tell them about your awful experiences.

 "Weirdest part was when I was in the hall of mirrors. That little girl gave me the creeps for some reason."
 "What little girl?" your brother looks at you puzzlingly.
 "Yeah, the little girl. Don't you remember? They have a soundtrack of a little girl giggling in the background, and they must do something with the mirrors so you see her running around, but you only see her hair and the ends of her dress. Freaky."
 "Dude… there was no soundtrack or speakers in that room. It was just an empty Hall of Mirrors room. Maybe those Circus clowns just got to your head! Hahaha!nd"

 As you and the group begin to walk away from the house, you can't help but notice a small plaque put in front of the Haunted House Ride.

-In Loving Memory of Sophia A. Harmon.  1897 - 1908. Resided on the property with her family, before the Harmon Family donated the estate to the theme park.-

Could it be…? Nah. Just your imagination…897 

    *** You have won ***

In that game you scored 6 out of a possible 7, in 27 turns.

Would you like to RESTART, RESTORE a saved game, QUIT, or UNDO the last command?

Please give one of the answers above.

Would you like to RESTART, RESTORE a saved game, QUIT, or UNDO the last command?

>undo
Darkness
[Previous turn undone.]

>combine flashlight
What do you want to combine the flashlight with?

>batteries
Looks like this flashlight should start working now!

You see a shadow of a little girl running out of the corner of your eye.

Narrow Hall of Terror
Finally you can see! You see a long, narrow hallway before you, filled with cobwebs and ghosts popping from the ceiling. A couple of robotic hands sticking out from the walls look like they're trying to grab you.

 The Meat Locker is West, but you see a Black Door to the East. Could this be the exit?.

You can see a Cobwebbed door here.

* * *

>e
You can't go that way.

>w
Victorian Living Room
Victorian furniture create a gloomy scene in this room, reminding you of a horror movie you watched about a murder in the 1800"s. The fireplace lets off an ominous purple glow (obviously done with purple flashlights and the shifting of the light.) There is a large, comfy couch, a sitting chair, a bookcase, a large painting of a grim old man, and a knight in rusty armor holding an axe.

The Black Room is to the East, and there is a door to the West.

You can see a Leather Couch, a Sitting Chair, a Bookcase, a Large Painting, a Knight in Rusty Armor, and a Fireplace here.

>w
Caged Rabid Animal Room
As you open the door letting off a horrifying creak, you see animatronic rats scurrying out of the corner of your eye. This doesn't bother you that much, until you see what is in the room. Large cages with robot animals that have fake foam oozing from their jowls. When you step close to one of the cages, a sensor goes off, and the animals leap against the wall of their cage, growling and chomping at you. It looks like one of the cages is unlocked…ﹱ

The Living Room is in the East, and the Next Room is in the West.

You can see an Animatronic Rats, a Cages, an Unlocked Cage, and a Broken Robotic Dog here.

>w
Circus Room
Great. A room devoted to the Circus. You've always hated the Circus, especially clowns. Large robotic clowns loom over you and a demonic low-voiced laughter rings through the room as a waltzing, repetitive circus song plays in the background. There is another podium at the entrance where a worker dressed as a ringmaster is supposed to welcome the guests.

The Cage Room is to the East, and there is a sliding door to the North of the room.

You can see a Red Podium and a Robot Clowns here.

>n
Graveyard Room
A large, very open room with the ceiling decorated to look like nighttime. The floor is littered with tombstones, but a large tombstone with a skeleton hugging the base of it really sticks out to you. The soundtrack to this room is howling wind and a wolf howling in the background.

The Circus Room is in the South. There is a door to the West that looks like it was decorated to not stand out. A door with a large mirror in the front is to the East. A room with what looks like fog coming out from under the door is to the North.

You can see a Tombstones, a Large Tombstone, and a Skeleton here.

>w
Staff Break Room
FINALLY. A soundproof room with nothing scary in it. This is obviously a break room for the staff during their downtime. There's a mini fridge, an old TV, an old couch, and a desk.

The entrance to the Graveyard is to the East, and there is a metal door to the North.

You can see a Mini Fridge, an Old TV, an Old Couch, and a Desk here.

>n
Control Panel Room
An old man is fumbling around with one of the boxes on the wall, cutting wires and reconnecting others. He must be the electrician, maybe he can help you find a way out! This seems to be the Control Panel room that has all the wires and switches causing the electricity to work. Someone must have forgotten to switch off the ride, since lights are flashing next to the switches labeled:

 Lighting
 Fog
 Soundtracks

You should turn off the fog and soundtracks, but leave the lighting on so you can see.

The Staff Break Room is South.

You can see a Switch for Lighting, a Switch for Fog, a Switch for Soundtracks, a Boxes, and an Old Electrician here.

>x old electrician
An old man wearing a grey jumpsuit cutting and reconnecting wires. Whatever he's doing looks very confusing.  He is carrying the key to the exit. He looks annoyed.

* * *

>push square
A door has opened to the west.
Another door has opened in the north.

* * *

>w
Victorian Living Room
Victorian furniture create a gloomy scene in this room, reminding you of a horror movie you watched about a murder in the 1800"s. The fireplace lets off an ominous purple glow (obviously done with purple flashlights and the shifting of the light.)

There is a large, comfy couch, a sitting chair, a bookcase, a large painting of a grim old man, and a knight in rusty armor holding an axe.

The Black Room is to the East, and there is a door to the West.

>x painting
A picture of an old man. There is a label underneath saying: "Dr. James F. Harmon, 1870 - 1932." Interesting prop, wonder where they found it.

 His eyes seem to be following you...

[Your score has just gone up by one point.]

* * *

>w
Victorian Living Room
Victorian furniture create a gloomy scene in this room, reminding you of a horror movie you watched about a murder in the 1800"s. The fireplace lets off an ominous purple glow (obviously done with purple flashlights and the shifting of the light.)

There is a large, comfy couch, a sitting chair, a bookcase, a large painting of a grim old man, and a knight in rusty armor holding an axe.

The Black Room is to the East, and there is a door to the West.

>take screwdriver
[Your score has just gone up by one point.]

>w
Caged Rabid Animal Room
As you open the door letting off a horrifying creak, you see animatronic rats scurrying out of the corner of your eye. This doesn't bother you that much, until you see what is in the room. Large cages with robot animals that have fake foam oozing from their jowls. When you step close to one of the cages, a sensor goes off, and the animals leap against the wall of their cage, growling and chomping at you.

It looks like one of the cages is unlocked…

The Living Room is in the East, and the Next Room is in the West.

>w
Circus Room
Great. A room devoted to the Circus. You've always hated the Circus, especially clowns.

Large robotic clowns loom over you and a demonic low-voiced laughter rings through the room as a waltzing, repetitive circus song plays in the background. There is another podium at the entrance where a worker dressed as a ringmaster is supposed to welcome the guests.

The Cage Room is to the East.

>take wrench
[Your score has just gone up by one point.]

>n
(first opening the sliding door)
It seems to be locked.

>take wirecutter
You can't see any such thing.

>w
You can't go that way.

>n
(first opening the sliding door)
It seems to be locked.

>push button
A door slides open in the North.

>n
Graveyard Room
A large, very open room with the ceiling decorated to look like nighttime. The floor is littered with tombstones, but a large tombstone with a skeleton hugging the base of it really sticks out to you. The soundtrack to this room is howling wind and a wolf howling in the background.

The Circus Room is in the South. There is a door to the West that looks like it was decorated to not stand out. A door with a large mirror in the front is to the East. A room with what looks like fog coming out from under the door is to the North.

* * *

>take wirecutter
[Your score has just gone up by one point.]

>e
Hall of Mirrors
There is no repetitive music playing, but this time, you hear giggling that sounds like it's coming from a little girl. You feel like you can almost see a little girl darting between the mirrors, as if the lace of her dress and her long black hair trailing behind her disappears from every corner. The workers must use some kind of trick with the mirrors.

 The entrance to the Graveyard is to the West.

>w
Graveyard Room
A large, very open room with the ceiling decorated to look like nighttime. The floor is littered with tombstones, but a large tombstone with a skeleton hugging the base of it really sticks out to you. The soundtrack to this room is howling wind and a wolf howling in the background.

The Circus Room is in the South. There is a door to the West that looks like it was decorated to not stand out. A door with a large mirror in the front is to the East. A room with what looks like fog coming out from under the door is to the North.

>w
Staff Break Room
FINALLY. A soundproof room with nothing scary in it. This is obviously a break room for the staff during their downtime. There's a mini fridge, an old TV, an old couch, and a desk.

The entrance to the Graveyard is to the East, and there is a metal door to the North.

>n
(first opening the Metal Door)
It seems to be locked.

>take key
(the Control Panel Room Key)
Taken.

>n
(first opening the Metal Door)
It seems to be locked.

>unlock metal door with key
Which do you mean, the Exit Key or the Control Panel Room Key?

>control panel room key
You unlock the Metal Door.

>n
(first opening the Metal Door)

Control Panel Room
An old man is fumbling around with one of the boxes on the wall, cutting wires and reconnecting others. He must be the electrician, maybe he can help you find a way out! Try talking to him!!!

This seems to be the Control Panel room that has all the wires and buttons causing the electricity to work. Someone must have forgotten to switch off the ride, since lights are flashing next to the buttons labeled:

 Lighting
 Fog
 Soundtracks

You should press the fog and soundtracks buttons, but leave the lighting on so you can see.

The Staff Break Room is South.

You can see an old electrician here.

>n
You can't go that way.

>give electrician wrench
Thanks!

[Your score has just gone up by one point.]

* * *

>e
Graveyard Room
A large, very open room with the ceiling decorated to look like nighttime. The floor is littered with tombstones, but a large tombstone with a skeleton hugging the base of it really sticks out to you. The soundtrack to this room is howling wind and a wolf howling in the background.

The Circus Room is in the South. There is a door to the West that looks like it was decorated to not stand out. A door with a large mirror in the front is to the East. A room with what looks like fog coming out from under the door is to the North.

>n
Meat Locker
It's too foggy to really see anything. There might be a door to the east. You just entered from the graveyard in the south.

You can see a Cobwebbed door here.

>unlock cobwebbed door
What do you want to unlock the Cobwebbed door with?

>exit key
I only understood you as far as wanting to exit.

>key
That's not a verb I recognise.

>unlock cobwebbed door with exit key
You unlock the Cobwebbed door.

>open door
You open the Cobwebbed door.

>e
Darkness
It is pitch dark, and you can't see a thing.

>w
Meat Locker
It's too foggy to really see anything. There might be a door to the east. You just entered from the graveyard in the south.

You can see a Cobwebbed door here.

>drop exit key
[Your score has just gone up by one point.]

>e
Darkness
It is pitch dark, and you can't see a thing.

* * *

>w
Victorian Living Room
Victorian furniture create a gloomy scene in this room, reminding you of a horror movie you watched about a murder in the 1800"s. The fireplace lets off an ominous purple glow (obviously done with purple flashlights and the shifting of the light.)

There is a large, comfy couch, a sitting chair, a bookcase, a large painting of a grim old man, and a knight in rusty armor holding an axe.

The Black Room is to the East, and there is a door to the West.

>take wrench
You can't see any such thing.

* * *

>w
Caged Rabid Animal Room
As you open the door letting off a horrifying creak, you see animatronic rats scurrying out of the corner of your eye. This doesn't bother you that much, until you see what is in the room. Large cages with robot animals that have fake foam oozing from their jowls. When you step close to one of the cages, a sensor goes off, and the animals leap against the wall of their cage, growling and chomping at you.

It looks like one of the cages is unlocked…愠楮

The Living Room is in the East, and the Next Room is in the West.

>w
Circus Room
Great. A room devoted to the Circus. You've always hated the Circus, especially clowns. Large robotic clowns loom over you and a demonic low-voiced laughter rings through the room as a waltzing, repetitive circus song plays in the background. There is another podium at the entrance where a worker dressed as a ringmaster is supposed to welcome the guests.

The Cage Room is to the East, and there is a sliding door to the North of the room.

>take screwdriver
You already have that.

>n
Graveyard Room
A large, very open room with the ceiling decorated to look like nighttime. The floor is littered with tombstones, but a large tombstone with a skeleton hugging the base of it really sticks out to you. The soundtrack to this room is howling wind and a wolf howling in the background.

The Circus Room is in the South. There is a door to the West that looks like it was decorated to not stand out. A door with a large mirror in the front is to the East. A room with what looks like fog coming out from under the door is to the North.

>s
Circus Room
Great. A room devoted to the Circus. You've always hated the Circus, especially clowns. Large robotic clowns loom over you and a demonic low-voiced laughter rings through the room as a waltzing, repetitive circus song plays in the background. There is another podium at the entrance where a worker dressed as a ringmaster is supposed to welcome the guests.

The Cage Room is to the East, and there is a sliding door to the North of the room.

>take wrench
[Your score has just gone up by one point.]

* * *

>n
Graveyard Room
A large, very open room with the ceiling decorated to look like nighttime. The floor is littered with tombstones, but a large tombstone with a skeleton hugging the base of it really sticks out to you. The soundtrack to this room is howling wind and a wolf howling in the background.

The Circus Room is in the South. There is a door to the West that looks like it was decorated to not stand out. A door with a large mirror in the front is to the East. A room with what looks like fog coming out from under the door is to the North.

>take screwdriver
You already have that.

>w
Staff Break Room
FINALLY. A soundproof room with nothing scary in it. This is obviously a break room for the staff during their downtime. There's a mini fridge, an old TV, an old couch, and a desk.

The entrance to the Graveyard is to the East, and there is a metal door to the North.

>e
Graveyard Room
A large, very open room with the ceiling decorated to look like nighttime. The floor is littered with tombstones, but a large tombstone with a skeleton hugging the base of it really sticks out to you. The soundtrack to this room is howling wind and a wolf howling in the background.

The Circus Room is in the South. There is a door to the West that looks like it was decorated to not stand out. A door with a large mirror in the front is to the East. A room with what looks like fog coming out from under the door is to the North.

>take wirecutter
[Your score has just gone up by one point.]

* * *

>give electrician wrench
Thanks!

[Your score has just gone up by one point.]

* * *

>e
Graveyard Room
A large, very open room with the ceiling decorated to look like nighttime. The floor is littered with tombstones, but a large tombstone with a skeleton hugging the base of it really sticks out to you. The soundtrack to this room is howling wind and a wolf howling in the background.

The Circus Room is in the South. There is a door to the West that looks like it was decorated to not stand out. A door with a large mirror in the front is to the East. A room with what looks like fog coming out from under the door is to the North.

>n
Meat Locker
It's too foggy to really see anything. There might be a door to the east. You just entered from the graveyard in the south.

>e
You can't go that way.

>s
Graveyard Room
A large, very open room with the ceiling decorated to look like nighttime. The floor is littered with tombstones, but a large tombstone with a skeleton hugging the base of it really sticks out to you. The soundtrack to this room is howling wind and a wolf howling in the background.

The Circus Room is in the South. There is a door to the West that looks like it was decorated to not stand out. A door with a large mirror in the front is to the East. A room with what looks like fog coming out from under the door is to the North.

>w
Staff Break Room
FINALLY. A soundproof room with nothing scary in it. This is obviously a break room for the staff during their downtime. There's a mini fridge, an old TV, an old couch, and a desk.

The entrance to the Graveyard is to the East, and there is a metal door to the North.

* * *

>turn off fog
That's not something you can switch.

>push fog
You hear a clicking noise. Something must have happened.

>s
Staff Break Room
FINALLY. A soundproof room with nothing scary in it. This is obviously a break room for the staff during their downtime. There's a mini fridge, an old TV, an old couch, and a desk.

The entrance to the Graveyard is to the East, and there is a metal door to the North.

* * *

>e
Graveyard Room
A large, very open room with the ceiling decorated to look like nighttime. The floor is littered with tombstones, but a large tombstone with a skeleton hugging the base of it really sticks out to you. The soundtrack to this room is howling wind and a wolf howling in the background.

The Circus Room is in the South. There is a door to the West that looks like it was decorated to not stand out. A door with a large mirror in the front is to the East. A room with what looks like fog coming out from under the door is to the North.

>n
Meat Locker
Large sacks of what looks like cow meat hang from the ceiling on metal hooks. Obviously, their plastic, but it still gives you the creeps being wrapped in the cloudy plastic. Usually, a worker dawning a butcher's outfit chases the visitors around towards the exit, but the fog is so thick, you can't see it.

 The Graveyard is South. There is a large cobwebbed door to the East.

>unlock cobwebbed door
(with the Exit Key)
You unlock the Cobwebbed door.

>open cobwebbed door
You open the Cobwebbed door.

>e
You can't go that way.

>w
You can't go that way.

You see a shadow of a little girl running out of the corner of your eye.

>e
You can't go that way.

>e
You can't go that way.

* * *

>w
Victorian Living Room
Victorian furniture create a gloomy scene in this room, reminding you of a horror movie you watched about a murder in the 1800"s. The fireplace lets off an ominous purple glow (obviously done with purple flashlights and the shifting of the light.) There is a large, comfy couch, a sitting chair, a bookcase, a large painting of a grim old man, and a knight in rusty armor holding an axe.

The Black Room is to the East, and there is a door to the West.

>w
Caged Rabid Animal Room
As you open the door letting off a horrifying creak, you see animatronic rats scurrying out of the corner of your eye. This doesn't bother you that much, until you see what is in the room. Large cages with robot animals that have fake foam oozing from their jowls. When you step close to one of the cages, a sensor goes off, and the animals leap against the wall of their cage, growling and chomping at you.

It looks like one of the cages is unlocked…愠楮

The Living Room is in the East, and the Next Room is in the West.

* * *

>w
Circus Room
Great. A room devoted to the Circus. You've always hated the Circus, especially clowns. Large robotic clowns loom over you and a demonic low-voiced laughter rings through the room as a waltzing, repetitive circus song plays in the background. There is another podium at the entrance where a worker dressed as a ringmaster is supposed to welcome the guests.

The Cage Room is to the East, and there is a sliding door to the North of the room.

>n
Graveyard Room
A large, very open room with the ceiling decorated to look like nighttime. The floor is littered with tombstones, but a large tombstone with a skeleton hugging the base of it really sticks out to you. The soundtrack to this room is howling wind and a wolf howling in the background.

The Circus Room is in the South. There is a door to the West that looks like it was decorated to not stand out. A door with a large mirror in the front is to the East. A room with what looks like fog coming out from under the door is to the North.

>n
Meat Locker
It's too foggy to really see anything. There might be a door to the east. You just entered from the graveyard in the south.

You can see a Cobwebbed door here.

>e
(first opening the Cobwebbed door)
It seems to be locked.

>s
Graveyard Room
A large, very open room with the ceiling decorated to look like nighttime. The floor is littered with tombstones, but a large tombstone with a skeleton hugging the base of it really sticks out to you. The soundtrack to this room is howling wind and a wolf howling in the background.

The Circus Room is in the South. There is a door to the West that looks like it was decorated to not stand out. A door with a large mirror in the front is to the East. A room with what looks like fog coming out from under the door is to the North.

>take wirecutter
[Your score has just gone up by one point.]

>s
Circus Room
Great. A room devoted to the Circus. You've always hated the Circus, especially clowns. Large robotic clowns loom over you and a demonic low-voiced laughter rings through the room as a waltzing, repetitive circus song plays in the background. There is another podium at the entrance where a worker dressed as a ringmaster is supposed to welcome the guests.

The Cage Room is to the East, and there is a sliding door to the North of the room.

* * *

>take wrench
[Your score has just gone up by one point.]

>e
Caged Rabid Animal Room
As you open the door letting off a horrifying creak, you see animatronic rats scurrying out of the corner of your eye. This doesn't bother you that much, until you see what is in the room. Large cages with robot animals that have fake foam oozing from their jowls. When you step close to one of the cages, a sensor goes off, and the animals leap against the wall of their cage, growling and chomping at you.

It looks like one of the cages is unlocked…愠楮

The Living Room is in the East, and the Next Room is in the West.

>take screwdriver
You can't see any such thing.

I beg your pardon?

>e
Victorian Living Room
Victorian furniture create a gloomy scene in this room, reminding you of a horror movie you watched about a murder in the 1800"s. The fireplace lets off an ominous purple glow (obviously done with purple flashlights and the shifting of the light.) There is a large, comfy couch, a sitting chair, a bookcase, a large painting of a grim old man, and a knight in rusty armor holding an axe.

The Black Room is to the East, and there is a door to the West.

>take screwdriver
[Your score has just gone up by one point.]

>e
Black Room
The floor, ceiling, and walls are all black. A booming voice sounds from a speaker coming from the wall saying: "How do you escape a room with NO WINDOWS, and NOOOO DOOORS. HA. HA. HA. HA. HA."

 Trying to calm yourself down, you notice a square section of the wall in front of you is an off black color.

>e
You can't go that way.

>w
Victorian Living Room
Victorian furniture create a gloomy scene in this room, reminding you of a horror movie you watched about a murder in the 1800"s. The fireplace lets off an ominous purple glow (obviously done with purple flashlights and the shifting of the light.) There is a large, comfy couch, a sitting chair, a bookcase, a large painting of a grim old man, and a knight in rusty armor holding an axe.

The Black Room is to the East, and there is a door to the West.

* * *

>n
Graveyard Room
A large, very open room with the ceiling decorated to look like nighttime. The floor is littered with tombstones, but a large tombstone with a skeleton hugging the base of it really sticks out to you. The soundtrack to this room is howling wind and a wolf howling in the background.

The Circus Room is in the South. There is a door to the West that looks like it was decorated to not stand out. A door with a large mirror in the front is to the East. A room with what looks like fog coming out from under the door is to the North.

>w
Staff Break Room
FINALLY. A soundproof room with nothing scary in it. This is obviously a break room for the staff during their downtime. There's a mini fridge, an old TV, an old couch, and a desk.

The entrance to the Graveyard is to the East, and there is a metal door to the North.

* * *

>e
(first opening the Cobwebbed door)
It seems to be locked.

>unlock door
What do you want to unlock the Cobwebbed door with?

>exit key
I only understood you as far as wanting to exit.

>i
You are carrying:
  an Exit Key
  a flashlight

>unlock cobwebbed door with key
You unlock the Cobwebbed door.

>open door
You open the Cobwebbed door.

>e
Darkness
It is pitch dark, and you can't see a thing.

You see a shadow of a little girl running out of the corner of your eye.

>e
Exit
FREEEEDOM! You feel the fresh air blowing through your hair, the sunlight against your skin, and the smell of food coming from the vendors parked across the street. Eventually, you meet up with your friends, and tell them about your awful experiences.

 "Weirdest part was when I was in the hall of mirrors. That little girl gave me the creeps for some reason."
 "What little girl?" your brother looks at you puzzlingly.
 "Yeah, the little girl. Don't you remember? They have a soundtrack of a little girl giggling in the background, and they must do something with the mirrors so you see her running around, but you only see her hair and the ends of her dress. Freaky."
 "Dude… there was no soundtrack or speakers in that room. It was just an empty Hall of Mirrors room. Maybe those Circus clowns just got to your head! Hahaha!nd"

 As you and the group begin to walk away from the house, you can't help but notice a small plaque put in front of the Haunted House Ride.

-In Loving Memory of Sophia A. Harmon.  1897 - 1908. Resided on the property with her family, before the Harmon Family donated the estate to the theme park.-

Could it be…? Nah. Just your imagination…897 

    *** You have won ***

In that game you scored 6 out of a possible 7, in 37 turns.

Would you like to RESTART, RESTORE a saved game, QUIT, or UNDO the last command?

* * *

>w
Circus Room
Great. A room devoted to the Circus. You've always hated the Circus, especially clowns. Large robotic clowns loom over you and a demonic low-voiced laughter rings through the room as a waltzing, repetitive circus song plays in the background. There is another podium at the entrance where a worker dressed as a ringmaster is supposed to welcome the guests.

The Cage Room is to the East, and there is a sliding door to the North of the room.

>n
Graveyard Room
A large, very open room with the ceiling decorated to look like nighttime. The floor is littered with tombstones, but a large tombstone with a skeleton hugging the base of it really sticks out to you. The soundtrack to this room is howling wind and a wolf howling in the background.

The Circus Room is in the South. There is a door to the West that looks like it was decorated to not stand out. A door with a large mirror in the front is to the East. A room with what looks like fog coming out from under the door is to the North.

You see a shadow of a little girl running out of the corner of your eye.

>n
Meat Locker
It's too foggy to really see anything. There might be a door to the east. You just entered from the graveyard in the south.

You can see a Cobwebbed door here.

>s
Graveyard Room
A large, very open room with the ceiling decorated to look like nighttime. The floor is littered with tombstones, but a large tombstone with a skeleton hugging the base of it really sticks out to you. The soundtrack to this room is howling wind and a wolf howling in the background.

The Circus Room is in the South. There is a door to the West that looks like it was decorated to not stand out. A door with a large mirror in the front is to the East. A room with what looks like fog coming out from under the door is to the North.

>take wirecutter
You see a shadow of a little girl running out of the corner of your eye.

[Your score has just gone up by one point.]

>s
Circus Room
Great. A room devoted to the Circus. You've always hated the Circus, especially clowns. Large robotic clowns loom over you and a demonic low-voiced laughter rings through the room as a waltzing, repetitive circus song plays in the background. There is another podium at the entrance where a worker dressed as a ringmaster is supposed to welcome the guests.

The Cage Room is to the East, and there is a sliding door to the North of the room.

* * *

>take screwdriver
You can't see any such thing.

>e
Victorian Living Room
Victorian furniture create a gloomy scene in this room, reminding you of a horror movie you watched about a murder in the 1800"s. The fireplace lets off an ominous purple glow (obviously done with purple flashlights and the shifting of the light.) There is a large, comfy couch, a sitting chair, a bookcase, a large painting of a grim old man, and a knight in rusty armor holding an axe.

The Black Room is to the East, and there is a door to the West.

* * *

>give electrician wrench
Thanks!

[Your score has just gone up by one point.]

>give electrician screwdriver
Thanks!

[Your score has just gone up by one point.]

>give electrician wirecutter
Thanks!

"Thanks a bunch kid! Here's the key that leads out of the Meat Locker. After the Narrow Hallway, you should be home free to the exit! Just leave the key for me though on the ground in the butcher room so I can get out too."

[Your score has just gone up by one point.]

>s
Staff Break Room
FINALLY. A soundproof room with nothing scary in it. This is obviously a break room for the staff during their downtime. There's a mini fridge, an old TV, an old couch, and a desk.

The entrance to the Graveyard is to the East, and there is a metal door to the North.

* * *

>key
You unlock the Cobwebbed door.

>open door
You open the Cobwebbed door.

* * *

>e
Darkness
It is pitch dark, and you can't see a thing.

>i
You are carrying:
  an Exit Key
  a batteries
  a flashlight

>combine batteries
What do you want to combine the batteries with?

>flashlight
Looks like this flashlight should start working now!

Narrow Hall of Terror
All you see is darkness. You need something to light the pathway, but you can tell the room is very narrow.

You can see a Cobwebbed door here.

* * *

>s
Black Room
The floor, ceiling, and walls are all black. A booming voice sounds from a speaker coming from the wall saying: "How do you escape a room with NO WINDOWS, and NOOOO DOOORS. HA. HA. HA. HA. HA."

 Trying to calm yourself down, you notice a square section of the wall in front of you is an off black color.

>e
You can't go that way.

* * *

>push square
A door has opened to the west.
Another door has opened in the north.

>e
You can't go that way.

>w
Victorian Living Room
Victorian furniture create a gloomy scene in this room, reminding you of a horror movie you watched about a murder in the 1800"s. The fireplace lets off an ominous purple glow (obviously done with purple flashlights and the shifting of the light.)

There is a large, comfy couch, a sitting chair, a bookcase, a large painting of a grim old man, and a knight in rusty armor holding an axe.

The Black Room is to the East, and there is a door to the West.

>w
Caged Rabid Animal Room
As you open the door letting off a horrifying creak, you see animatronic rats scurrying out of the corner of your eye. This doesn't bother you that much, until you see what is in the room. Large cages with robot animals that have fake foam oozing from their jowls. When you step close to one of the cages, a sensor goes off, and the animals leap against the wall of their cage, growling and chomping at you.

It looks like one of the cages is unlocked…愠楮

The Living Room is in the East, and the Next Room is in the West.

>w
Circus Room
Great. A room devoted to the Circus. You've always hated the Circus, especially clowns.

Large robotic clowns loom over you and a demonic low-voiced laughter rings through the room as a waltzing, repetitive circus song plays in the background. There is another podium at the entrance where a worker dressed as a ringmaster is supposed to welcome the guests.

The Cage Room is to the East.

You see a shadow of a little girl running out of the corner of your eye.

>n
You can't go that way.

>e
Hall of Mirrors
There is no repetitive music playing, but this time, you hear giggling that sounds like it's coming from a little girl. You feel like you can almost see a little girl darting between the mirrors, as if the lace of her dress and her long black hair trailing behind her disappears from every corner. The workers must use some kind of trick with the mirrors.

 The entrance to the Graveyard is to the West.

* * *

>w
Graveyard Room
A large, very open room with the ceiling decorated to look like nighttime. The floor is littered with tombstones, but a large tombstone with a skeleton hugging the base of it really sticks out to you. The soundtrack to this room is howling wind and a wolf howling in the background.

The Circus Room is in the South. There is a door to the West that looks like it was decorated to not stand out. A door with a large mirror in the front is to the East. A room with what looks like fog coming out from under the door is to the North.

>s
Circus Room
Great. A room devoted to the Circus. You've always hated the Circus, especially clowns. Large robotic clowns loom over you and a demonic low-voiced laughter rings through the room as a waltzing, repetitive circus song plays in the background. There is another podium at the entrance where a worker dressed as a ringmaster is supposed to welcome the guests.

The Cage Room is to the East, and there is a sliding door to the North of the room.

>e
Caged Rabid Animal Room
As you open the door letting off a horrifying creak, you see animatronic rats scurrying out of the corner of your eye. This doesn't bother you that much, until you see what is in the room. Large cages with robot animals that have fake foam oozing from their jowls. When you step close to one of the cages, a sensor goes off, and the animals leap against the wall of their cage, growling and chomping at you.

It looks like one of the cages is unlocked…愠楮

The Living Room is in the East, and the Next Room is in the West.

>take batteries
Taken.

>e
Victorian Living Room
Victorian furniture create a gloomy scene in this room, reminding you of a horror movie you watched about a murder in the 1800"s. The fireplace lets off an ominous purple glow (obviously done with purple flashlights and the shifting of the light.) There is a large, comfy couch, a sitting chair, a bookcase, a large painting of a grim old man, and a knight in rusty armor holding an axe.

The Black Room is to the East, and there is a door to the West.

>e
Black Room
The floor, ceiling, and walls are all black. A booming voice sounds from a speaker coming from the wall saying: "How do you escape a room with NO WINDOWS, and NOOOO DOOORS. HA. HA. HA. HA. HA."

 Trying to calm yourself down, you notice a square section of the wall in front of you is an off black color.

>n
Entrance to the ride
The front door is barricaded from the outside, so you'll have to find another exit, which should be at the end of the ride. The room is dimly lighted with a podium at the front were a greeter stands to maintain the line.

South is the first room of the ride.

* * *

>take flashlight
Taken.

>combine flashlight
What do you want to combine the flashlight with?

>batteries
Looks like this flashlight should start working now!

[Your score has just gone up by one point.]

* * *

>n
You can't go that way.

>x podium
Another podium, this time matching the color scheme of the room. Usually, a worker dressed as a clown ringmaster stands here to guide the guests to the exit.

 There seems to be a red button on the surface of the podium.

>push button
You can't see any such thing.

>push red button
You can't see any such thing.

* * *

>w
Circus Room
Great. A room devoted to the Circus. You've always hated the Circus, especially clowns.

Large robotic clowns loom over you and a demonic low-voiced laughter rings through the room as a waltzing, repetitive circus song plays in the background. There is another podium at the entrance where a worker dressed as a ringmaster is supposed to welcome the guests.

The Cage Room is to the East.

You see a shadow of a little girl running out of the corner of your eye.

>push button
A door slides open in the North.

* * *

>n
Graveyard Room
A large, very open room with the ceiling decorated to look like nighttime. The floor is littered with tombstones, but a large tombstone with a skeleton hugging the base of it really sticks out to you. The soundtrack to this room is howling wind and a wolf howling in the background.

The Circus Room is in the South. There is a door to the West that looks like it was decorated to not stand out. A door with a large mirror in the front is to the East. A room with what looks like fog coming out from under the door is to the North.

>x tombstone
Which do you mean, the Tombstones or the Large Tombstone?

>large
A large fake tombstone. Probably the biggest monster in this room hides behind here. An ominous skeleton is hugging the foot of the tombstone.

>x skeleton
Just a normal skeleton. It seems to be holding a wirecutter in it's ivory left hand.

>w
Staff Break Room
FINALLY. A soundproof room with nothing scary in it. This is obviously a break room for the staff during their downtime. There's a mini fridge, an old TV, an old couch, and a desk.

The entrance to the Graveyard is to the East, and there is a metal door to the North.

>n
(first opening the Control Room Door)
It seems to be locked.

* * *

>w
Victorian Living Room
Victorian furniture create a gloomy scene in this room, reminding you of a horror movie you watched about a murder in the 1800"s. The fireplace lets off an ominous purple glow (obviously done with purple flashlights and the shifting of the light.)

There is a large, comfy couch, a sitting chair, a bookcase, a large painting of a grim old man, and a knight in rusty armor holding an axe.

The Black Room is to the East, and there is a door to the West.

>e
Black Room
A room where the ceiling, walls, and floor are all painted black. The entrance to the next room is West, the entrance to the Haunted House is North.