You got separated from your friends and older brother in a Haunted House Ride at the Local Theme Park. Unfortunately, the staff thought that the last of the guests had left, and all of the doors have been locked. Yet, all of the machines in the house are still strangely working. You fainted from fear at the last ghostly "surprise," and you wake up in an unfamiliar room.

Haunted House of Hallucinations
An Interactive Fiction by Erika Payne Disable take all
Release 1 / Serial number 131009 / Inform 7 build 6G60 (I6/v6.32 lib 6/12N) SD

Black Room
The floor, ceiling, and walls are all black. A booming voice sounds from a speaker coming from the wall saying: "How do you escape a room with NO WINDOWS, and NOOOO DOOORS. HA. HA. HA. HA. HA."

 Trying to calm yourself down, you notice a square section of the wall in front of you is an off black color.

>push black square
A door has opened to the west.
Another door has opened in the north.

>w
Victorian Living Room
Victorian furniture create a gloomy scene in this room, reminding you of a horror movie you watched about a murder in the 1800"s. The fireplace lets off an ominous purple glow (obviously done with purple flashlights and the shifting of the light.) There is a large, comfy couch, a sitting chair, a bookcase, a large painting of a grim old man, and a knight in rusty armor holding an axe.

The Black Room is to the East, and there is a door to the West.

You can see a Black door, a Leather Couch, a Sitting Chair, a Bookcase, a Large Painting, a Knight in Rusty Armor, a Fireplace, and a screwdriver here.

>w
Caged Rabid Animal Room
As you open the door letting off a horrifying creak, you see animatronic rats scurrying out of the corner of your eye. This doesn't bother you that much, until you see what is in the room. Large cages with robot animals that have fake foam oozing from their jowls. When you step close to one of the cages, a sensor goes off, and the animals leap against the wall of their cage, growling and chomping at you. It looks like one of the cages is unlocked…ﹲ

The Living Room is in the East, and the Next Room is in the West.

You can see an Animatronic Rats, a Cages, an Unlocked Cage, and a Broken Robotic Dog here.

>w
Circus Room
Great. A room devoted to the Circus. You've always hated the Circus, especially clowns. Large robotic clowns loom over you and a demonic low-voiced laughter rings through the room as a waltzing, repetitive circus song plays in the background. There is another podium at the entrance where a worker dressed as a ringmaster is supposed to welcome the guests.

The Cage Room is to the East, and there is a sliding door to the North of the room.

You can see a Red Podium, a Robot Clowns, and a wrench here.

>n
Graveyard Room
A large, very open room with the ceiling decorated to look like nighttime. The floor is littered with tombstones, but a large tombstone with a skeleton hugging the base of it really sticks out to you. The soundtrack to this room is howling wind and a wolf howling in the background.

The Circus Room is in the South. There is a door to the West that looks like it was decorated to not stand out. A door with a large mirror in the front is to the East. A room with what looks like fog coming out from under the door is to the North.

You can see a Tombstones, a Large Tombstone, a Skeleton, and a wirecutter here.

>w
Staff Break Room
FINALLY. A soundproof room with nothing scary in it. This is obviously a break room for the staff during their downtime. There's a mini fridge, an old TV, an old couch, and a desk.

The entrance to the Graveyard is to the East, and there is a metal door to the North.

You can see a Mini Fridge, an Old TV, an Old Couch, and a Desk here.

* * *

I beg your pardon?

I beg your pardon?

* * *

>x player
You can't see any such thing.

* * *

>push square
A door has opened to the west.
Another door has opened in the north.

* * *

>n
Entrance to the ride
The front door is barricaded from the outside, so you'll have to find another exit, which should be at the end of the ride. The room is dimly lighted with a podium at the front were a greeter stands to maintain the line.

South is the first room of the ride.

>x podium
A normal podium that a greeter will stand at to maintain the lines of the ride. There is a space inside the podium with what looks like some junk in it.

In the podium is a flashlight.

>take flashlight
Taken.

>x flashlight
Better take it. In a place like this, it might be helpful for later.

>turn on flashlight
That's not something you can switch.

>s
Black Room
The floor, ceiling, and walls are all black. A booming voice sounds from a speaker coming from the wall saying: "How do you escape a room with NO WINDOWS, and NOOOO DOOORS. HA. HA. HA. HA. HA." The door you had just entered is behind you, of course, but it looks locked.

 Trying to calm yourself down, you notice a square section of the wall in front of you is an off black color.

>w
Victorian Living Room
Victorian furniture create a gloomy scene in this room, reminding you of a horror movie you watched about a murder in the 1800"s. The fireplace lets off an ominous purple glow (obviously done with purple flashlights and the shifting of the light.) There is a large, comfy couch, a sitting chair, a bookcase, a large painting of a grim old man, and a knight in rusty armor holding an axe.

The Black Room is to the East, and there is a door to the West.

You can see a screwdriver here.

>x couch
A red, leather couch with large cushions that looks very inviting. People dressed as ghosts usually lounge on the couch and jump out at people passing by the room.

>w
caged rabid animal room
As you open the door letting off a horrifying creak, you see animatronic rats scurrying out of the corner of your eye. This doesn't bother you that much, until you see what is in the room. Large cages with robot animals that have fake foam oozing from their jowls. When you step close to one of the cages, a sensor goes off, and the animals leap against the wall of their cage, growling and chomping at you. It looks like one of the cages is unlocked…

The Living Room is in the East, and the Next Room is in the West.

You can see an Animatronic Rats, a Cages, an Unlocked Cage, and a Broken Robotic Dog here.

>w
Circus Room
Great. A room devoted to the Circus. You've always hated the Circus, especially clowns. Large robotic clowns loom over you and a demonic low-voiced laughter rings through the room as a waltzing, repetitive circus song plays in the background. There is another podium at the entrance where a worker dressed as a ringmaster is supposed to welcome the guests.

The Cage Room is to the East, and there is a sliding door to the North of the room.

You can see a Red Podium and a Robot Clowns here.

* * *

>w
Staff Break Room
FINALLY. A soundproof room with nothing scary in it. This is obviously a break room for the staff during their downtime. There's a mini fridge, an old TV, an old couch, and a desk.

The entrance to the Graveyard is to the East, and there is a metal door to the North.

You can see a Mini Fridge, an Old TV, an Old Couch, and a Desk here.

>x couch
An old, dusty couch that employees can chillax on.

* * *

>w
Circus Room
Great. A room devoted to the Circus. You've always hated the Circus, especially clowns. Large robotic clowns loom over you and a demonic low-voiced laughter rings through the room as a waltzing, repetitive circus song plays in the background. There is another podium at the entrance where a worker dressed as a ringmaster is supposed to welcome the guests.

The Cage Room is to the East, and there is a sliding door to the North of the room.

You can see a wrench here.

>n
Graveyard Room
A large, very open room with the ceiling decorated to look like nighttime. The floor is littered with tombstones, but a large tombstone with a skeleton hugging the base of it really sticks out to you. The soundtrack to this room is howling wind and a wolf howling in the background.

The Circus Room is in the South. There is a door to the West that looks like it was decorated to not stand out. A door with a large mirror in the front is to the East. A room with what looks like fog coming out from under the door is to the North.

You can see a Tombstones, a Large Tombstone, and a Skeleton here.

* * *

>x switch
Which do you mean, the Switch for Lighting, the Switch for Fog, or the Switch for Soundtracks?

>lighting
Controls all the lighting in the ride. I suggest keeping that on.

* * *

>take wrench
[Your score has just gone up by one point.]

>take wrench
You already have that.

I beg your pardon?

>drop wrench
Dropped.

>take wrench
Taken.

* * *

>w
Caged Rabid Animal Room
As you open the door letting off a horrifying creak, you see animatronic rats scurrying out of the corner of your eye. This doesn't bother you that much, until you see what is in the room. Large cages with robot animals that have fake foam oozing from their jowls. When you step close to one of the cages, a sensor goes off, and the animals leap against the wall of their cage, growling and chomping at you. It looks like one of the cages is unlocked…

The Living Room is in the East, and the Next Room is in the West.

You can see an Unlocked Cage and a batteries here.

>x cage
A cage door has been left open at the end of the room, and a broken looking robotic dog is looking down.

>x dog
Someone must have been trying to fix him earlier, because most of the wiring has been ripped apart. You can see a pair of batteries sticking out from the jowls. Those probably power the red eyes.

>take batteries
That's hardly portable.

* * *

>w
Victorian Living Room
Victorian furniture create a gloomy scene in this room, reminding you of a horror movie you watched about a murder in the 1800"s. The fireplace lets off an ominous purple glow (obviously done with purple flashlights and the shifting of the light.) There is a large, comfy couch, a sitting chair, a bookcase, a large painting of a grim old man, and a knight in rusty armor holding an axe.

The Black Room is to the East, and there is a door to the West.

You can see a screwdriver here.

>look under bookcase
You find nothing of interest.

* * *

>w
Victorian Living Room
Victorian furniture create a gloomy scene in this room, reminding you of a horror movie you watched about a murder in the 1800"s. The fireplace lets off an ominous purple glow (obviously done with purple flashlights and the shifting of the light.) There is a large, comfy couch, a sitting chair, a bookcase, a large painting of a grim old man, and a knight in rusty armor holding an axe.

The Black Room is to the East, and there is a door to the West.

You can see a screwdriver here.

>e
Black Room
The floor, ceiling, and walls are all black. A booming voice sounds from a speaker coming from the wall saying: "How do you escape a room with NO WINDOWS, and NOOOO DOOORS. HA. HA. HA. HA. HA." The door you had just entered is behind you, of course, but it looks locked.

 Trying to calm yourself down, you notice a square section of the wall in front of you to the West is an off black color.

You can see a Black door, a Second door, and a Black Square here.

>n
Entrance to the ride
The front door is barricaded from the outside, so you'll have to find another exit, which should be at the end of the ride. The room is dimly lighted with a podium at the front were a greeter stands to maintain the line.

South is the first room of the ride.

You can see a Second door, a podium (in which is a flashlight), and a front door here.

>x door
Which do you mean, the Second door or the front door?

>front door
The front door to the ride. For some reason, it's barricaded outside. You will have to find another way out.

* * *

>take wrench
[Your score has just gone up by one point.]

>w
You can't go that way.

>n
Graveyard Room
A large, very open room with the ceiling decorated to look like nighttime. The floor is littered with tombstones, but a large tombstone with a skeleton hugging the base of it really sticks out to you. The soundtrack to this room is howling wind and a wolf howling in the background.

The Circus Room is in the South. There is a door to the West that looks like it was decorated to not stand out. A door with a large mirror in the front is to the East. A room with what looks like fog coming out from under the door is to the North.

You can see a wirecutter here.

* * *

>n
Control Panel Room
An old man is fumbling around with one of the boxes on the wall, cutting wires and reconnecting others. He must be the electrician, maybe he can help you find a way out! This seems to be the Control Panel room that has all the wires and switches causing the electricity to work. Someone must have forgotten to switch off the ride, since lights are flashing next to the switches labeled:

 Lighting
 Fog
 Soundtracks

You should turn off the fog and soundtracks, but leave the lighting on so you can see.

The Staff Break Room is South.

You can see an old electrician here.

>talk to old electrician
That's not a verb I recognise.

>x old electrician
An old man wearing a grey jumpsuit cutting and reconnecting wires. Whatever he's doing looks very confusing.  He is carrying the key to the exit. He looks annoyed.

>ask old electrician about the key to the exit
There is no reply.

>ask old electrician for key
"What are you doing here, the ride's closed! ... What? They locked you in while closing down? Sorry to hear that, but I can't help you. I only got the one spare key, and I'm gonna be here for a couple hours. Maybe we can make an exchange though, I seem to be missing some of my tools… Three of them to be exact. I probably dropped them in some of the rooms that came before the graveyard. Try giving a look for them, this old heart of mine couldn't stand going through that Circus Room again."

>give wrench to old electrician
Thanks kid!

[Your score has just gone up by one point.]

>give wirecutter to the old electrician
Thanks kid!

[Your score has just gone up by one point.]

>take wirecutter
That seems to belong to the old electrician.

>give screwdriver to the old electrician
Thanks kid!

[Your score has just gone up by one point.]

>x old electrician
An old man wearing a grey jumpsuit cutting and reconnecting wires. Whatever he's doing looks very confusing.  He is carrying the key to the exit. He looks fine.

* * *

>w
Caged Rabid Animal Room
As you open the door letting off a horrifying creak, you see animatronic rats scurrying out of the corner of your eye. This doesn't bother you that much, until you see what is in the room. Large cages with robot animals that have fake foam oozing from their jowls. When you step close to one of the cages, a sensor goes off, and the animals leap against the wall of their cage, growling and chomping at you. It looks like one of the cages is unlocked…

The Living Room is in the East, and the Next Room is in the West.

You can see an Unlocked Cage and a batteries here.

>x unlocked cage
A cage door has been left open at the end of the room, and a broken looking robotic dog is looking down.

>x do
You can't see any such thing.

>x dog
Someone must have been trying to fix him earlier, because most of the wiring has been ripped apart. You can see a pair of batteries sticking out from the jowls. Those probably power the red eyes.

>take batteries
You can't see any such thing.

* * *

>e
You can't go that way.

>n
Entrance to the Ride
The front door is barricaded from the outside, so you'll have to find another exit, which should be at the end of the ride. The room is dimly lighted with a podium at the front were a greeter stands to maintain the line.

South is the first room of the ride.

You can see a podium here.

>s
Black Room
The floor, ceiling, and walls are all black. A booming voice sounds from a speaker coming from the wall saying: "How do you escape a room with NO WINDOWS, and NOOOO DOOORS. HA. HA. HA. HA. HA."

 Trying to calm yourself down, you notice a square section of the wall in front of you to the West is an off/black color.

>w
Victorian Living Room
Victorian furniture create a gloomy scene in this room, reminding you of a horror movie you watched about a murder in the 1800"s. The fireplace lets off an ominous purple glow (obviously done with purple flashlights and the shifting of the light.) There is a large, comfy couch, a sitting chair, a bookcase, a large painting of a grim old man, and a knight in rusty armor holding an axe.

The Black Room is to the East, and there is a door to the West.

You can see a Leather Couch, a Sitting Chair, a Bookcase, a Large Painting, a Knight in Rusty Armor, and a Fireplace here.

* * *

>w
(first opening the Black door)
It seems to be locked.

>push square
A door has opened to the west.
Another door has opened in the north.

* * *

>w
Victorian Living Room
Victorian furniture create a gloomy scene in this room, reminding you of a horror movie you watched about a murder in the 1800"s. The fireplace lets off an ominous purple glow (obviously done with purple flashlights and the shifting of the light.) There is a large, comfy couch, a sitting chair, a bookcase, a large painting of a grim old man, and a knight in rusty armor holding an axe.

The Black Room is to the East, and there is a door to the West.

You can see a screwdriver here.

>take wrench
You can't see any such thing.

>take wirecutter
You can't see any such thing.

>take screwdriver
That's hardly portable.

* * *

>w
Victorian Living Room
Victorian furniture create a gloomy scene in this room, reminding you of a horror movie you watched about a murder in the 1800"s. The fireplace lets off an ominous purple glow (obviously done with purple flashlights and the shifting of the light.) There is a large, comfy couch, a sitting chair, a bookcase, a large painting of a grim old man, and a knight in rusty armor holding an axe.

The Black Room is to the East, and there is a door to the West.

You can see a screwdriver here.

>take screwdrier
You can't see any such thing.

>take screwdriver
Taken.

>w
Caged Rabid Animal Room
As you open the door letting off a horrifying creak, you see animatronic rats scurrying out of the corner of your eye. This doesn't bother you that much, until you see what is in the room. Large cages with robot animals that have fake foam oozing from their jowls. When you step close to one of the cages, a sensor goes off, and the animals leap against the wall of their cage, growling and chomping at you. It looks like one of the cages is unlocked…

The Living Room is in the East, and the Next Room is in the West.

You can see an Unlocked Cage scenery here.

* * *

>s
Black Room
The floor, ceiling, and walls are all black. A booming voice sounds from a speaker coming from the wall saying: "How do you escape a room with NO WINDOWS, and NOOOO DOOORS. HA. HA. HA. HA. HA."

 Trying to calm yourself down, you notice a square section of the wall in front of you to the West is an off/black color.

>w
Victorian Living Room
Victorian furniture create a gloomy scene in this room, reminding you of a horror movie you watched about a murder in the 1800"s. The fireplace lets off an ominous purple glow (obviously done with purple flashlights and the shifting of the light.) There is a large, comfy couch, a sitting chair, a bookcase, a large painting of a grim old man, and a knight in rusty armor holding an axe.

The Black Room is to the East, and there is a door to the West.

You can see a Leather Couch, a Sitting Chair, a Bookcase, a Large Painting, a Knight in Rusty Armor and a Fireplace here.

>w
Caged Rabid Animal Room
As you open the door letting off a horrifying creak, you see animatronic rats scurrying out of the corner of your eye. This doesn't bother you that much, until you see what is in the room. Large cages with robot animals that have fake foam oozing from their jowls. When you step close to one of the cages, a sensor goes off, and the animals leap against the wall of their cage, growling and chomping at you. It looks like one of the cages is unlocked…

The Living Room is in the East, and the Next Room is in the West.

You can see an Animatronic Rats, a Cages, an Unlocked Cage and a Broken Robotic Dog here.

>w
Circus Room
Great. A room devoted to the Circus. You've always hated the Circus, especially clowns. Large robotic clowns loom over you and a demonic low-voiced laughter rings through the room as a waltzing, repetitive circus song plays in the background. There is another podium at the entrance where a worker dressed as a ringmaster is supposed to welcome the guests.

The Cage Room is to the East, and there is a sliding door to the North of the room.

You can see a Red Podium and a Robot Clowns here.

>n
Graveyard Room
A large, very open room with the ceiling decorated to look like nighttime. The floor is littered with tombstones, but a large tombstone with a skeleton hugging the base of it really sticks out to you. The soundtrack to this room is howling wind and a wolf howling in the background.

The Circus Room is in the South. There is a door to the West that looks like it was decorated to not stand out. A door with a large mirror in the front is to the East. A room with what looks like fog coming out from under the door is to the North.

You can see a Tombstones, a Large Tombstone and a Skeleton here.

>n
Meat Locker
Large sacks of what looks like cow meat hang from the ceiling on metal hooks. Obviously, their plastic, but it still gives you the creeps being wrapped in the cloudy plastic. Usually, a worker dawning a butcher's outfit chases the visitors around towards the exit, but the fog is so thick, you can't see it.

 The Graveyard is South.

You can see a Cow Meat and a Metal Hooks here.

>e
Narrow Hall of Terror
All you see is darkness. You need something to light the pathway, but you can tell the room is very narrow.

The Meat Locker is West.

You can see a Cobwebs and a Robotic Hands here.

>e
Exit
FREEEEDOM! You feel the fresh air blowing through your hair, the sunlight against your skin, and the smell of food coming from the vendors parked across the street. Eventually, you meet up with your friends, and tell them about your awful experiences.

 "Weirdest part was when I was in the hall of mirrors. That little girl gave me the creeps for some reason."
 "What little girl?" your brother looks at you puzzlingly.
 "Yeah, the little girl. Don't you remember? They have a soundtrack of a little girl giggling in the background, and they must do something with the mirrors so you see her running around, but you only see her hair and the ends of her dress. Freaky."
 "Dude… there was no soundtrack or speakers in that room. It was just an empty Hall of Mirrors room. Maybe those Circus clowns just got to your head! Hahaha!nd, bu"

 As you and the group begin to walk away from the house, you can't help but notice a small plaque put in front of the Haunted House Ride.

-In Loving Memory of Sophia A. Harmon.  1897 - 1908. Resided on the property with her family, before the Harmon Family donated the estate to the theme park.-

Could it be…? Nah. Just your imagination…897 - 1908. 

    *** You have won ***

In that game you scored 0 out of a possible 0, in 8 turns.

Would you like to RESTART, RESTORE a saved game, QUIT or UNDO the last command?